XXXXXXXXXXX
X     XX  X
X XXX XXX X
X         X
XXXXXXXXXXX
XXXXXXXXXXX