XXXXXXXXXXXXXXXXXXXXXXXXXXXXXXX
X     X X   X   X         X X X
X XXXXX X XXX XXX XXXXX XXX X X
X         X X       X X X X   X
X XXX XXX X X X XXXXX XXX XXX X
X X X   X     X       X   X   X
X X XXX X XXXXXXXXXXXXX XXXXX X
X     X X   X X   X   X   X   X
XXX XXXXX XXX X X X XXX XXX XXX
X       X     X X           X X
XXX X X XXXXX X XXXXXXX XXX X X
X   X X   X     X     X   X   X
XXXXX XXXXX XXX X X X X XXX X X
X     X X X   X   X X X   X X X
XXX X X X XXXXX XXX XXXXXXX X X
X   X       X     X       X X X
XXXXXXXXXXXXXXXXXXXXXXXXXXXXXXX