XXXXXXXXXXXXXXXXXXXXXXXXXXXXXXXXXXXXXXXXXXXXXXXXXXXXXXXXXXXXXXXXXXXXXXXXXXXXXXXXXXXXXXXXXXXXXXXXXXXXX
X       X X X     X     X   X       X           X   X X X   X     X X X         X       X X       X X
XXX XXX X X X XXXXX XXXXX XXX XXXXXXXXXXX XXXXXXX X X X X XXX XXXXX X X XXXXXXXXX XXXXXXX X X X XXX X
X     X       X         X   X X   X       X X   X X   X   X   X X X X         X X X X X X   X X     X
XXX X X X XXXXX XXX XXXXX XXX X XXXXXXXXX X X XXX X XXX XXX XXX X X X XXX X XXX X X X X X XXXXXXXXXXX
X   X X X         X X           X   X X X X X X   X X X     X   X X   X X X X   X   X   X X       X X
X XXX X XXX XXXXX XXX X X XXXXXXX X X X X X X X XXXXX X XXXXXXX X X XXX XXXXX XXX XXXXX X XXX XXXXX X
X X   X   X     X   X X X X   X   X X       X X X X X X X X     X X     X X X   X X X     X X       X
X XXX XXXXXXX XXX XXX X XXXXX X XXXXXXX X XXX X X X X X X X X XXX X XXXXX X X XXX X X XXXXX X XXXXX X
X X X       X X     X X X     X X X X X X         X X       X X         X X X X X   X   X   X   X X X
X X X XXXXX X XXX XXX XXX XXXXX X X X XXX X XXXXXXX XXX XXX X X X X XXXXX X X X X XXXXX X XXX XXX XXX
X X     X   X   X     X     X             X           X   X X   X X           X X   X X             X
XXX XXXXX X XXXXXXXXX XXX XXX XXX XXX XXX X X XXXXXXXXX XXXXXXXXXXXXXXX XXXXXXX X XXX X X XXX X XXXXX
X X X   X X     X X X X         X   X X   X X                     X   X X X X           X   X X   X X
X X X XXXXX XXXXX X XXX XXXXX XXXXX XXXXX XXX XXXXXXXXXXXXXXXXX XXX XXXXX X XXX XXX XXXXX X X XXXXX X
X       X     X   X       X X   X     X     X                 X   X X   X   X     X   X X X X   X   X
XXX X X XXX XXXXX X XXXXX X XXX XXX XXXXX XXX X X X XXXXX XXXXXXXXX XXX X XXX X X XXX X XXXXXXXXX XXX
X   X X X               X     X X     X X   X X X X X               X X       X X   X X       X X   X
XXX X XXXXX XXX XXXXXXX XXXXXXXXXXX XXX XXX X X X XXXXXXX X XXX XXXXX X XXXXX X XXXXX X X X X X X XXX
X   X   X     X       X           X   X   X X X X   X     X X               X X X X     X X X       X
X X X X X XXX XXX X X X XXX XXX XXX XXXXX XXXXX XXX XXX XXX XXXXXXX XXXXX XXXXXXX XXX XXX XXXXXXXXXXX
X X X X X   X   X X X X   X X X   X X         X X X X X   X   X   X   X   X         X X X           X
X X XXX X X X X XXXXX XXX XXX X XXXXX XXXXXXXXXXX XXX XXXXXXXXX XXXXXXXXXXX XXX XXXXX X X X X XXXXXXX
X X X   X X X X     X   X     X       X       X X X   X X X       X           X     X   X X X   X X X
X XXX XXXXX X X X X XXXXX XXXXXXX XXX X XXXXX X X X XXX X X X XXXXX XXXXX X XXXXXXXXXXXXXXX X X X X X
X X X   X   X X X X   X       X     X     X X X X   X X X X X X         X X             X X X X X   X
XXX X XXX X XXX X XXX XXX XXXXX X X X X X X XXX X X X X X XXX X XXX X X XXX X X XXXXXXX X XXXXXXXXX X
X     X   X X   X   X X       X X X X X X   X X   X             X   X X   X X X       X     X       X
X X XXX X X X X XXXXX XXX X XXXXXXXXXXX X XXX X XXXXX XXXXXXX XXXXXXX X XXXXX XXX XXXXX X XXX XXXXX X
X X X   X X X X   X X X   X         X   X           X   X   X     X X X   X X X X     X X         X X
XXX X XXXXXXX X X X XXX X XXXXXXXXX XXXXX X X X X XXX XXX XXX X XXX XXXXXXX X X XXX XXXXX X XXXXX X X
X   X     X   X X     X X         X   X X X X X X X         X X             X     X   X   X   X   X X
XXX XXXXX XXX X XXX X X XXX XXXXXXXXXXX X X XXX XXX X X XXX X XXXXXXX X XXX XXXXX X XXXXXXX XXXXXXXXX
X     X     X X X   X X   X         X     X X   X   X X X X X   X X X X   X     X X   X X X         X
X XXX X XXXXXXX X XXX X X X XXXXX XXX X X XXX XXXXX XXX X XXX XXX X X XXX XXXXXXXXXXXXX X XXXXXXXXXXX
X   X X X       X X   X X X   X X X   X X X   X   X X       X       X   X                   X       X
X XXX XXXXXXX X XXX X X XXXXXXX XXXXXXX XXXXXXXXX X XXX XXX X X X X XXXXX XXX XXX X XXX XXXXXXX XXX X
X   X X X     X   X X X   X         X X       X X     X   X X X X X     X   X   X X X X           X X
X X XXX XXX XXXXX X X X X X XXX XXXXX XXX X XXX XXX XXXXX X X XXXXX XXX XXXXX X X X X XXXXXXXXXXXXXXX
X X X       X     X X X X   X           X X X           X X X X X X   X     X X X X                 X
X XXXXXXXXX XXX X X XXX X XXX XXX XXX XXX XXXXX X XXX XXXXXXX X X XXX XXX XXX XXXXX X XXX X X XXXXXXX
X   X         X X X   X X   X   X   X X X X X X X X X       X     X X X     X     X X   X X X     X X
X XXXXXXXXX XXX X X XXX X X XXXXX XXXXX XXX X XXXXX X X XXXXXXXXX X XXXXX X X XXXXXXX XXX X XXX XXX X
X X           X X X X   X X     X   X X X X X X X     X         X     X X X X       X   X X   X     X
X XXX XXX XXX XXX X XXX X XXXXX XXXXX X X X X X XXXXX XXX X X XXX XXXXX X XXXXXXX X X XXXXXXXXXXXXX X
X X X X     X X X X X   X     X   X X X X       X     X   X X   X       X       X X X             X X
X X X X XXXXX X XXX XXXXX XXXXX X X X X X XXXXXXXXXXX XXX XXXXX XXX X X X X X XXX XXXXX X X XXX XXX X
X X   X     X     X X X       X X               X       X     X   X X X X X X   X     X X X   X   X X
XXX X X XXXXXXX X XXX X X X XXX X X X XXXXX XXX XXXXX XXX XXX XXXXXXXXX X X XXX X XXXXX XXX XXX XXX X
X   X X   X     X X     X X   X X X X     X X       X   X   X       X   X X   X X     X X     X   X X
XXXXXXXXXXXXXXXXXXXXXXXXXXXXXXXXXXXXXXXXXXXXXXXXXXXXXXXXXXXXXXXXXXXXXXXXXXXXXXXXXXXXXXXXXXXXXXXXXXXXX
