XXXXXXXXXXXXXXXXXXXXXXXXXXXXXXXXXXXXXXXXXXXXXXXXXXXXXXXXXXXXXXXXXXXXXXXXXXXXXXXXXXXXXXXXXXXXXXXXXXXXXXXXXXXXXXXXXXXXXXXXXXXXXXXXXXXXXXXXXXXXX
X     X X     X X                   X X   X   X X   X X   X     X X X X X       X       X   X X   X                         X X     X     X X
XXX XXX X XXXXX X XXXXX X XXXXXXXXXXX X XXX XXX X XXX X XXX XXXXX X X X XXX XXXXX XXXXXXX XXX X XXX X XXX X X XXX XXXXX XXX X XXX XXX XXX X X
X                 X   X X       X     X     X     X   X   X   X X     X X         X   X     X       X   X X X X X X X     X             X X X
X X XXXXX X XXXXX XXX XXXXXXXXX X XXX X XXX X XXXXX XXX XXX XXX X XXXXX X XXX X XXX XXX XXX X XXX XXXXXXXXX X X X X XXXXX XXXXXXX X XXX XXX X
X X     X X     X     X       X     X   X X                 X               X X     X     X   X X       X X X   X X     X     X X X   X X   X
X X X XXX XXXXXXXXXXX XXX XXX X XXXXXXX X X X XXX X XXX XXX X XXXXX XXXXX XXXXXXX X X XXXXXXXXX XXXXXXXXX XXXXXXX X XXXXX XXXXX XXX X X X XXX
X X X X             X X X X X X     X     X X   X X   X   X     X       X       X X           X X     X   X   X X     X X   X X   X X X     X
X X XXX X X XXX X X XXX X X XXX XXXXXXX X XXX XXX XXXXXXXXXXXXXXXXXXXXX X X XXXXXXX XXXXXXXXX X X XXX X XXX X X XXX XXX XXXXX X X XXXXXXX XXX
X X   X X X X   X X         X X       X X X X   X X     X         X X   X X     X X         X   X X X     X X     X         X   X     X X   X
X XXX XXXXX XXX XXX XXXXXXXXX XXX XXXXXXX X XXXXXXX XXX X X XXXXXXX XXX XXXXXXXXX XXX X X XXXXXXX X X XXXXX XXXXX XXX X X X X XXXXXXXXX XXX X
X X   X       X   X             X       X           X X X X X   X     X             X X X   X       X         X X   X X X X   X       X X   X
XXXXXXX X XXXXX XXXXX X XXXXX XXXXXXXXXXXXX X XXXXXXX XXX XXX XXXXX XXXXX X XXXXXXXXXXX X X XXX XXX XXX XXX XXX XXX X XXXXXXXXX XXXXXXX XXXXX
X       X     X   X   X X   X   X X X   X   X     X X                   X X   X       X X X X X   X   X X         X X       X   X     X     X
X XXX X X XXXXX XXXXX X X XXXXXXX X X XXXXXXX XXX X X X XXX X XXX X X XXX XXXXX XXX XXXXX XXX X X XXXXXXXXXXXXXXXXX X XXX XXX XXX X XXX X XXX
X X X X X X       X   X       X X X     X   X   X X   X X   X   X X X X           X X X X X     X     X X   X X   X X X X X       X     X X X
XXX XXXXX XXX X XXX X X X X XXX X X XXXXXXX XXXXXXX XXXXX X X XXXXX XXXXX XXX X XXXXX X X X XXX XXXXXXX X XXX X XXXXXXX X X XXXXX XXX XXXXX X
X X X       X X   X X X X X X           X               X X X   X X X X     X X X     X       X           X X   X     X     X X X   X       X
X X XXX X XXXXXXX X XXXXX XXX XXXXX XXXXXXX XXX X XXX XXX X XXX X XXX XXX XXX X X XXXXXXXXX XXXXXXX XXX XXX X X X XXXXX X XXX X X XXXXXXXXX X
X       X   X   X X X X X         X X X X     X X   X   X X   X         X   X X   X     X X   X   X   X       X X   X X X       X         X X
X XXX X XXXXXXX X XXX X XXX XXXXX XXX X XXX XXXXXXX X XXXXX XXX XXX XXXXXXXXXXX XXX XXXXX X X X XXXXXXX X XXX XXX XXX XXX XXXXX XXXXX X XXXXX
X X   X   X         X     X     X                 X X   X X X     X X X X X X X X   X   X X X         X X X       X     X     X     X X     X
X XXXXX XXXXX XXXXX X XXX X X XXXXX XXXXXXXXX XXXXXXXXXXX XXXXXXXXX X X X X X XXX XXX XXX XXXXXXXXX X X X X X XXX X XXX XXX XXXXX XXXXXXXXXXX
X X       X X   X       X X X X X     X     X   X X     X         X X                   X   X     X X X X X X X X   X X X     X X           X
XXXXX XXX X XXX X XXXXXXXXXXXXX XXXXX X XXXXXXXXX X XXXXX XXXXXXX XXX XXXXXXXXX X XXXXX X XXX XXXXXXXXXXXXX X X X XXX X XXXXX X XXX XXXXXXX X
X     X       X X               X                   X X       X X X X     X X   X     X           X X X   X X   X     X X X       X       X X
XXX X XXX X XXXXX XXXXX XXX X XXXXX X X X X X X XXX X X XXXXXXX XXX X XXXXX XXX XXXXXXXXX XXXXXXXXX X XXX XXXXXXX X XXXXX XXX XXX X X XXXXX X
X   X   X X     X X     X   X   X X X X X X X X   X                           X         X       X X         X   X X     X X     X X X     X X
X X X XXX XXX XXX XXX X XXXXX XXX XXX X XXXXXXXXX X X XXX X X XXXXXXX X XXXXXXX XXXXXXXXX X XXXXX X XXXXX X X XXX XXX XXX XXX XXX XXXXX XXXXX
X X X X X X X X     X X   X         X X X X     X X X X X X X   X   X X   X   X X   X X X X       X     X X X X X   X     X   X X   X       X
XXX XXX XXX XXXXX XXX X XXX X XXXXX XXX X X XXXXXXXXX X X XXX XXX X X X XXX XXXXX XXX X XXXXXXXXX X X XXXXXXX X XXXXX XXX XXXXX XXXXX X X XXX
X               X   X X   X X   X     X       X     X   X X X     X X X           X X       X X     X     X   X X   X X X X X   X X   X X   X
X X XXXXX XXX XXXXXXX X XXX X X XXXXX X X XXXXX XXXXXXXXXXX XXXXXXX XXXXX X XXX XXX X XXXXXXX XXXXX X XXXXX XXX X XXXXX XXX X X X XXXXX X XXX
X X     X X         X X X X X X     X X X         X X X           X     X X   X       X X X   X   X X   X       X             X       X X   X
XXX XXX X X X X X XXX XXX X X XXX XXXXXXX X XXXXXXX X X X XXX XXX X X XXX X XXXXX X X X X X XXX XXX XXXXX XXXXXXX XXX X XXX XXXXXXX X XXX XXX
X     X X X X X X   X X     X   X     X   X             X   X   X X X   X X   X   X X X X         X   X       X X   X X   X       X X X X   X
X X X X X X X XXX XXXXXXX X XXXXX XXXXXXX XXX X X X X XXX X X XXXXXXXXX X XXX X XXX XXX XXX X XXXXXXXXX X X X X X XXXXXXXXXXXXXXXXXXXXX XXXXX
X X X X X X X X       X   X     X     X   X   X X X X   X X X X       X X   X X X           X           X X X X X   X X                   X X
X X XXXXXXXXXXX XXX XXXXX XXXXXXX XXXXX XXXXXXX X XXXXX X XXX X XXX X XXXXXXX X X X X XXX XXX X X XXX X XXXXXXX X X X X XXXXXXXXX X XXXXXXX X
X X         X     X X         X       X X   X X X   X X X   X     X X X X X X X X X X   X   X X X X   X           X X       X X X X         X
XXX X XXX XXX X XXXXXXX XXX XXXXXXX XXXXX XXX XXX X X X X X X X XXX X X X X X X X X XXX XXX XXXXX XXX XXX X XXX X XXX XXXXXXX X XXXXX XXXXXXX
X X X X     X X   X X   X         X X X       X X X   X X X X X X   X       X X X X   X   X     X   X   X X X X X                   X X X   X
X X XXXXXXX XXXXX X XXX X XXX X X XXX X XXXXXXX X XXXXXXXXXXX X XXXXXXXXXXXXXXXXXXX X XXXXXXXXX XXX X X XXX X X X X X XXX XXXXXXX XXX X XXX X
X         X X X X X     X X   X X X             X       X     X X     X   X X   X X X         X X X X X X     X X X X   X   X   X X   X     X
XXX X XXX XXX X XXXXX X XXXXX XXX X XXX XXXXX X XXXXX X XXXXXXX X XXXXX XXX X XXX XXX X XXXXX XXX X XXXXXXXXX XXXXXXXXXXXXXXX XXXXXXXXXXX XXX
X   X   X         X X X X       X     X X   X X     X X       X   X X X X     X   X   X     X     X X       X                 X             X
X X XXXXX XXXXX XXX X X X XXX XXX X X XXX XXX XXXXXXX X X XXXXX X X X X XXX X X XXXXX X XXXXXXX X XXX XXXXXXXXX X XXXXXXXXXXX X XXXXXXXXXXXXX
X X     X   X     X   X X X     X X X       X       X X X   X   X X       X X     X   X       X X X   X X X     X     X X   X               X
X X XXX X XXXXXXX XXX XXX X X X X X XXX X X X X X X X XXX XXX XXX X XXXXXXX X X X XXXXXXX X XXXXX X X X X X X X X X X X X X XXXXXXX XXXXXXX X
X X X X X       X X     X X X X X X   X X X X X X X X X     X X             X X X       X X   X     X     X X X X X X     X       X     X   X
X XXX XXX X XXXXXXX XXXXX XXX X XXX X X XXX XXX XXXXXXX X X XXX XXX XXXXXXXXX X XXX XXX XXXXXXXXXXXXX XXX X XXXXXXXXX X X X X XXXXXXX XXXXX X
X     X   X   X     X       X X   X X X   X   X X     X X X X   X   X X     X X   X X             X     X X   X X X   X X X X     X X X   X X
XXX XXXXX XXX X X XXXXX X X XXX X X X X X XXX X X X XXXXXXX XXX X X X X XXXXXXX XXXXXXX XXX XXXXX XXX XXXXXXXXX X XXXXXXXXXXXXXXXXX X X XXX X
X   X     X   X X X     X X   X X X X X X X   X   X   X       X X X X     X   X       X   X X X X X                   X   X   X X   X     X X
X X X X XXX X XXXXX X X XXXXX XXX XXX X X XXXXXXX XXX XXX X XXX XXX X XXX X XXX XXXXX XXX X X X X XXXXX X X XXXXX XXX X XXX XXX X XXX X XXX X
X X X X X X X   X   X X     X   X   X X X       X   X X X X X   X X     X     X   X     X X     X   X   X X   X X   X X       X     X X X   X
X XXXXX X XXX XXXXX X X X X X XXXXXXXXXXXXX XXXXX XXXXX XXX XXX X X XXX XXXXX XXX XXX XXXXX XXXXX X XXXXX X X X XXXXX X XXXXX X XXX X XXX XXX
X     X   X   X     X X X X X             X X       X         X X     X     X   X X X     X     X X     X X X   X         X X     X X   X X X
X XXXXX X X X X X XXX X X XXX XXXXX XXX X X XXX X X X X XXXXX XXXXXXX X XXX XXX XXX XXXXX X X X X X XXX X XXXXX XXX X X XXX X X XXXXX X XXX X
X     X X X X X X   X X X   X     X   X X X   X X X X X X           X X   X X X X     X X X X X X X   X X     X   X X X     X X   X   X     X
X X X XXX XXXXXXXXXXXXX X X X X X X X X XXX X XXXXX XXX XXXXXXX X XXX X XXX X X X XXXXX X X X X XXX XXX XXX XXX X XXX XXX X XXXXXXXXXXX X X X
X X X X X X X       X   X X X X X X X X   X X     X X     X     X X X X X     X         X X X X   X X X X   X X X X   X   X   X   X   X X X X
X XXXXX XXX X XXXXX X X XXXXX X XXX X XXXXX X X X X X X X XXX XXX X XXX XXXXX X XXXXXXX X X X XXXXXXX XXXXX X XXX XXXXXXXXX X X XXX XXXXXXX X
X       X     X       X   X   X   X X     X X X X X X X X   X X       X X X   X   X   X X X X   X       X       X     X     X     X     X   X
X XXX XXXXXXX XXX X X X X X X X XXXXXXXXX XXXXXXX XXX XXXXXXX XXX X X XXX XXX XXX X X XXXXXXX XXX XXXXXXX X X XXXXXXX XXXXX XXXXXXX X XXXXX X
X   X   X     X   X X X X X X X         X       X X     X   X X   X X   X   X X     X   X X             X X X X     X X           X X     X X
XXX XXXXXXX XXX XXX X X XXXXX XXXXX XXXXX X XXX XXX X XXX XXXXXXXXX XXXXX XXX XXX X X XXX X X X XXXXXXXXX XXXXX X XXX XXXXX X X XXX X XXXXXXX
X       X   X     X X X X   X   X       X X   X X   X   X X X       X X   X X X   X X   X   X X         X X     X X     X   X X     X     X X
X X XXXXX X XXX X XXXXX X XXX X XXX XXXXXXXXX X X XXX XXX X XXXXXXX X XXX X X X X XXXXXXX XXX X XXXXX XXXXX XXXXXXX X X X X XXXXXXXXXXX X X X
X X   X   X   X X X         X X   X         X X X X         X               X X X       X   X X     X             X X X X X           X X   X
XXXXXXXXXXXXXXXXXXXXXXXXXXXXXXXXXXXXXXXXXXXXXXXXXXXXXXXXXXXXXXXXXXXXXXXXXXXXXXXXXXXXXXXXXXXXXXXXXXXXXXXXXXXXXXXXXXXXXXXXXXXXXXXXXXXXXXXXXXXXX
