XXXXXXXXXXXXXXXXXXXXX
X           X X X   X
X XXXXXXXXXXX X X XXX
X           X X     X
X X XXXXXXXXX X XXXXX
X X     X X X       X
X X XXXXX X X X XXXXX
X X   X   X   X     X
X X X XXX X XXX X XXX
X X X       X   X   X
XXXXXXXXXXXXXXXXXXXXX